20
15
22 22 22 22 22 22 22 22 22 22 22 22 22 22 22 22 22 22 22 22 
22 22 22 22 22 22 22 22 22 22 22 41 40 22 22 22 22 22 22 22 
22 22 22 22 19 17 18 22 22 22 22 4 27 18 22 20 22 22 22 22 
22 22 22 19 0 0 0 18 22 22 19 1 27 0 17 3 22 22 22 22 
22 22 22 4 0 0 0 3 22 19 0 0 0 0 0 3 22 22 22 22 
22 22 19 0 0 0 0 3 22 4 0 0 0 0 0 0 18 22 22 22 
22 22 4 0 0 0 0 0 17 0 0 0 0 0 0 0 0 18 22 22 
22 22 4 0 0 0 0 0 0 0 0 0 0 0 0 0 0 0 18 22 
22 19 0 0 0 0 0 0 0 0 0 0 0 0 0 0 0 0 3 22 
22 4 0 0 0 0 0 0 0 0 0 0 0 0 0 0 0 0 3 22 
22 4 0 0 0 0 0 0 0 0 0 0 0 0 0 0 0 0 3 22 
22 4 0 0 0 0 0 0 0 0 0 0 0 0 0 0 0 0 3 22 
22 4 0 9 0 0 0 0 0 0 11 0 0 0 10 0 0 0 3 22 
22 4 23 24 24 24 24 24 24 24 24 24 24 24 24 24 24 25 3 22 
0 0 0 0 0 0 0 0 0 0 0 0 0 0 0 0 0 0 0 0 
